11 0 0 0 0 1 0 0 0 0 1 0 0 0 0 10
11 0 0 0 0 1 0 0 0 0 1 0 0 0 0 10 
10 0 0 0 0 1 0 0 0 0 1 0 0 0 0 11
10 0 0 0 0 1 0 0 0 0 1 0 0 0 0 11 
1 0 0 0 0 1 1 1 1 1 1 0 0 0 0 1
1 0 0 0 0 0 0 0 0 0 0 0 0 0 0 1  
1 0 0 0 0 0 0 0 0 0 0 0 0 0 0 1  
1 0 0 0 0 0 0 0 0 0 0 0 0 0 0 1  
1 0 0 0 0 1 13 1 1 1 1 0 0 0 0 1  
1 1 1 1 1 0 0 0 0 0 0 1 1 1 1 1  
